########
#     S#
# ###  #
#      #
# #  # #
# ######
# ###  #
##### ##
#   #  #
#   # E#
########