##########
#  S     #
# ### ## #
# #    # #
# #  # # #
# ## #####
# #      #
# # #  # #
##### ####
#   #    #
# #    #E#
##########