#############################################
#E       #             #  #   #        #    #
####### ############# ### ### ########## ####
#       #               #   #               #
# ####### # ########### ### ### #############
#   #     #   #           #   #             #
# ### ##### ### ######### ### ###############
#     #     #   #   #     #                 #
####### ##### # # # # ### ############# #####
#     #           #     # #   #             #
# ############# ##### ### # ############# ###
#     #           #     #   #   #           #
# ############# ##### ### # ############# ###
#     #           #     #   #   #           #
# ############# ##### ### # ############# ###
#     #                 #   #   #           #
# ############# ##### ### # ############# ###
#     #     #     #     #   #   #   #       #
####### ### ##### # ##### ### ### # #########
#   #     #       #   #     #   #   #       #
# ##### ##### ##### # ##### ### # ###########
#   #   #       #   #     #   #   #         #
# ### ### ##### ### ##### ### # #############
#   #     #   #     #     #   #   #         #
####### ### # ##### # ######### #############
#   #     #   #     #     #   #   #         #
# ##### ### # ##### # ##### ### #############
#   #     #   #     #     #   #   #         #
# ######### ### ##### # ##### ###############
#   #     #   #     # # #   #   #           #
####### ### # ##### # # ### ### #############
#     #   #   #     # #     #   #           #
# ########### # ##### ######### #############
#     #   #   #     # #     #   #           #
# ######### ### ##### # ##### ###############
#   #     #   #     # # #   #   #           #
# ##### ### # ##### # # ### ### #############
#   #     #   #     # #     #   #           #
# ######### ### ##### ######### #############
#   #     #   #     #         #   #         #
# ##### ### # ##### ############# ###########
#   #     #   #     #         #   #      S  #
####### ###                         #########
#############################################